################################
##S                            #
##################             #
#                              #
#                              #
#            G                 #
#                              #
################################